##########################
#........................#
#........................#
#...........###..........#
#...........###..........#
#........................#
#........................#
##########################