##############################
#..............##..#.........#
#11.####.11111.##.##.....1111#
#.1...#..1............1..11.1#
#.1...#..1..#####.1.1.1111..1#
#........1..#.....1.1......11#
#.............111.11111.##...#
#.......#####.........1.###..#
###.....###.............#.####
#...#.........#.....111...#..#
###.###########.111111.......#
#............................#
#11.1.111.1..111111.11.....###
#.1...1...1.......1.1...1....#
#...111.1.........111.111.####
#.1.....1.....1.111...1.1....#
#.111.1.1.###.1.111.111.11111#
#.....1...........1.....1....#
#####.1...............1.111.1#
#.....1.............1.1...1.1#
#...1.111..####.111.1.111.111#
#...1...1...........1........#
#111111...###....##...#.....##
#.....................#...#..#
#.#.....###..##.......###.####
#.#......##.###..............#
#....................##.1.####
#1111...........111.##..1....#
#........#.#.#..111.##.11....#
##############################