###############
#...#####.....#
###.####...####
#........#....#
#.######.###..#
#..#.#.....#..#
#..#.#.#.#.#..#
#..#...#.#.##.#
#..###.#...#..#
#.........##.##
#...#...#.##.##
#..###.......##
##...#.########
####..........#
###############
