###############
#...1..11.....#
###.11.11..####
#........2....#
#.222222.222..#
#..2.2.....2..#
#..2.2.111.2..#
#..2...111.22.#
#..222.1...2..#
#.........22.##
##.......222.##
##.111.......##
##..11111..####
#.............#
###############